   lang.idioms = {
      arp:     'All Ranking Points',
      act:     'Actual',
      rlp:     'Points - Ranking Lists',
      trn:     'Tournament',
      rnd:     'Round',
      dt:      'Date',
      fmt:     'Format',
      cat:     'Category',
      cta:     'Cat.',
      rnk:     'Rank',
      rl:      'Rank List',
      ply:     'Player',
      pyr:     'Players',
      add:     'Add',
      sgi:     'Sign-In',
      sgo:     'Sign-Out',
      scr:     'Score',
      pts:     'Points',
      mts:     'Matches',
      drw:     'Draw',
      drz:     'Draws',
      evt:     'Events',
      sch:     'Schedule',
      crt:     'Courts',
      id:      'ID',
      nm:      'Name',
      fnm:     'First Name',
      lnm:     'Last Name',
      bd:      'Birthday',
      yr:      'Year',
      byr:     'Year',
      tot:     'Total',
      sgl:     'Singles',
      dbl:     'Doubles',
      qal:     'Qualifying',
      rrb:     'Round Robin',
      snr:     'Senior',
      unk:     'Unknown',
      dup:     'Duplicate',
      stt:     'Status',
      ord:     'Order',
      clb:     'Club',
      cty:     'City',
      cnt:     'Country',
      kwn:     'Known',
      ioc:     'IOC',
      act:     'Action',
      agd:     'Assigned',
      igr:     'Ignore',
      igd:     'Ignored',
      edt:     'Edit Player',
      sbt:     'Submit',
      ccl:     'Cancel',
      clr:     'Clear',
      und:     'Undo',
      apt:     'Accept',
      dss:     'Dismiss',
      frm:     'From',
      to:      'To',
      h2h:     'Head-to-Head',
      reg:     'Registered',
      gdr:     'Gender',
      dtp:     'Draw Type',
      drp:     'Draw Position',
      adr:     'Automated Draw',
      mdo:     'Manual Draw Order',

      search: {
         players: 'Search Players',
         tournaments: 'Search Tournaments',
         clubs: 'Search Clubs',
      },

      formats: {
         singles: 'Singles',
         doubles: 'Doubles',
      },

      draws: {
         feedin: 'Feed-in',
         standard: 'Standard',
         structure: 'Structure',
         brackets: 'Brackets',
         bracketsize: 'Bracket Size',
         roundrobin: 'Round Robin',
         elimination: 'Elimination',
         consolation: 'Consolation',
         qualification: 'Qualification',
         remove: 'Remove',
      },

      ddlb: {
         singles:  'Singles Tournament Rank:&nbsp;',
         doubles:  'Doubles Tournament Rank:&nbsp;',
         category: 'Tournament Category:&nbsp;',
         draws:    'Select Event:',
      },

      phrases: {
         action: 'Players requiring some action...',
         search: 'Use the search field above to find players, or click player to edit',
         assign: 'Assign this profile by clicking a player below, or ...&nbsp',
         accept: '&nbspall players',
         trnyz:  'Loading Tournaments ...',
         badfile: 'File Not Recognized',
         invalid: 'Invalid file type',
         fileerror: 'Error reading file',
         pointcalc: 'Point calculation requires tournament category and rank',
      },

      events: {
         name: 'Name',
         opponents: 'Opponents',
         teams: 'Teams',
         draw_type: 'Draw Type',
         draw_size: 'Size',
         created: 'Created',
         category: 'Category',
         rank: 'Rank',
         surface: 'Surface',
         approved: 'Approved',
         eligible: 'Eligible',
         ineligible: 'Ineligible',
         unavailable: 'Unavailable',
      },

      genders: {
         male: 'Male',
         female: 'Female',
         mixed: 'Mixed',
      },

      surfaces: {
         clay: 'Clay',
         hard: 'Hard',
         grass: 'Grass',
         carpet: 'Carpet',
      },

      actions: {
         add_event: 'Add Event',
         save_event: 'Save Event',
         done: 'Done',
         cancel: 'Cancel',
         delete_event: 'Delete Event',
      },

      signin: {
         tournament_date: 'Start Date',
         organizer: 'Organizer',
         place: 'Location',
         id: 'Tournament ID',
         rank: 'Tournament Rank',
         judge: 'Head Judge',
         doc_name: 'SIGN-IN SHEET',
         doc_subname: ' ',
         signature: 'Signature',
         registered: 'Registered Players',
         notsignedin: 'Not Signed In',
         signedin: 'Signed In',
         withdrawn: 'Withdrawn',
      },

      misc: {
         registrations: 'Updating Registered Players...',
         approve: 'Approve',
         remove: 'Remove',
         loading: 'Loading Players...',
         calendar: 'Updating Calendar...',
         clubs: 'Loading Clubs...',
         tournaments: 'Loading Tournaments...',
         rankorder: 'Rank Order',
         refresh: 'Refresh',
      }

   }
